#######################################
# Syntax Coloring Map For PixelNutApp
#######################################

#######################################
# Classes and Structures
#######################################

PixelNutApp	KEYWORD1
AppCommands	KEYWORD1
CustomCode 	KEYWORD1
Bluetooth 	KEYWORD1

#######################################
# Methods, Functions, Variables
#######################################	

SetupLEDs	KEYWORD2
BlinkStatusLED	KEYWORD2
ErrorHandler	KEYWORD2
SetupDebugInterface	KEYWORD2

SetupBrightControls	KEYWORD2
SetupDelayControls	KEYWORD2
SetupPatternControls	KEYWORD2
SetupEModeControls	KEYWORD2
SetupTriggerControls	KEYWORD2
SetupColorControls	KEYWORD2
SetupCountControls	KEYWORD2
SetupTriggerControls	KEYWORD2

CheckBrightControls	KEYWORD2
CheckDelayControls	KEYWORD2
CheckPatternControls	KEYWORD2
CheckEModeControls	KEYWORD2
CheckColorControls	KEYWORD2
CheckCountControls	KEYWORD2
CheckTriggerControls	KEYWORD2

CheckForPatterns	KEYWORD2
GetCurPattern	KEYWORD2
GetNextPattern	KEYWORD2
GetPrevPattern	KEYWORD2
CheckExecCmd	KEYWORD2

cmdStr	KEYWORD2
codePatterns	KEYWORD2
curPattern	KEYWORD2
doUpdate	KEYWORD2
customPatterns	KEYWORD2
pixelBytes	KEYWORD2
pPixelData	KEYWORD2
pNeoPixels	KEYWORD2
pixelNutSupport	KEYWORD2
pPixelNutEngine	KEYWORD2
pPluginFactory	KEYWORD2

#######################################
# Constants
#######################################

# Debug Control

DEBUG_OUTPUT	LITERAL1
DEBUG_SIGNON	LITERAL1

# Software Settings

NUM_PLUGIN_LAYERS	LITERAL1
NUM_PLUGIN_TRACKS	LITERAL1
STRLEN_PATTERNS	LITERAL1

CUSTOM_PATTERNS	LITERAL1
BASIC_PATTERNS	LITERAL1
CUSTOM_PLUGINS	LITERAL1

STRAND_COUNT	LITERAL1
SEGMENT_COUNT	LITERAL1
SEGMENT_INFO	LITERAL1

EXTERNAL_COMM	LITERAL1
BLUETOOTH_COMM	LITERAL1
WIFI_COMM	LITERAL1
USE_WIFI_SOFTAP	LITERAL1
USE_PARTICLE_NAME	LITERAL1
DEFAULT_WIFI_INFO	LITERAL1
PARTICLE_PRODUCT_ID	LITERAL1

FEATURE_BITS	LITERAL1

# Hardware Controls

PIXEL_COUNT	LITERAL1
PIXEL_OFFSET	LITERAL1
DIRECTION_UP	LITERAL1

MAX_BRIGHTNESS	LITERAL1
DELAY_RANGE	LITERAL1
DELAY_OFFSET	LITERAL1

EEPROM_FORMAT	LITERAL1
EEPROM_BYTES	LITERAL1
EEPROM_FREE_START	LITERAL1
EEPROM_FREE_BYTES	LITERAL1

BRIGHT_POT_BACKWARDS	LITERAL1
DELAY_POT_BACKWARDS	LITERAL1

LED_ACTIVE_LOW	LITERAL1

# Hardware Pins

DPIN_LED	LITERAL1
DPIN_PIXELS	LITERAL1
DPIN_PATTERN_BUTTON	LITERAL1
DPIN_PAT_BUTTON_PREV	LITERAL1
DPIN_TRIGGER_BUTTON	LITERAL1
DPIN_EMODE_BUTTON	LITERAL1
DPIN_COUNT_BUTTON	LITERAL1
DPIN_DELAY_BUTTON	LITERAL1
DPIN_BRIGHT_BUTTON	LITERAL1
APIN_TRIGGER_POT	LITERAL1
APIN_HUE_POT	LITERAL1
APIN_WHITE_POT	LITERAL1
APIN_COUNT_POT	LITERAL1
APIN_DELAY_POT	LITERAL1
APIN_BRIGHT_POT	LITERAL1
APIN_SEED	LITERAL1

BLUEFRUIT_SPI_CS	LITERAL1
BLUEFRUIT_SPI_IRQ	LITERAL1
BLUEFRUIT_SPI_RST	LITERAL1

# Code Overrides

DRAWPIXS_OVERRIDE	LITERAL1
NEOPIXELS_OVERRIDE	LITERAL1
PIXENGINE_OVERRIDE	LITERAL1
PLUGINS_OVERRIDE	LITERAL1
APPCMDS_OVERRIDE	LITERAL1
CUSTOM_OVERRIDE	LITERAL1
MAIN_OVERRIDE	LITERAL1
